0	0	0	1	-1	0	-1	-1	1	0	0	0	1	-1	-1	-1	
0	1	0	-1	1	0	-1	0	-1	0	0	0	-1	-1	-1	1	
0	0	1	0	-1	0	1	-1	0	0	-1	0	0	-1	0	1	
-1	0	0	0	1	-1	-1	0	0	-1	0	-1	0	1	-1	-1	
-1	-1	-1	-1	-1	-1	1	0	-1	0	-1	0	-1	0	-1	1	
0	0	0	0	0	0	0	-1	1	1	-1	0	-1	0	0	1	
-1	-1	0	0	0	-1	0	-1	-1	0	1	0	-1	1	0	1	
-1	0	0	0	0	-1	-1	1	-1	-1	0	-1	1	1	0	1	
1	-1	0	0	0	-1	-1	0	0	1	0	1	0	0	-1	0	
0	-1	-1	0	-1	-1	1	1	0	0	-1	0	0	0	1	0	
0	-1	0	0	-1	1	-1	1	0	0	-1	0	-1	0	0	-1	
1	-1	0	1	0	1	0	0	-1	0	-1	-1	-1	0	0	-1	
0	0	1	1	-1	0	0	1	0	0	-1	-1	0	-1	-1	-1	
0	0	0	0	0	-1	0	0	0	0	0	-1	0	1	0	0	
1	1	0	0	1	0	1	0	0	0	0	-1	1	0	1	0	
0	-1	-1	0	-1	-1	1	0	1	0	0	0	0	-1	0	0	
12	4	5	8	10	
12	4	5	8	10	
1	1	2	3	4	
2